
   F 100,206,235
  C 99,99,99


	NO	/Users/oelboukh/Desktop/cuby/ray_cast/bbbb.xpm
   SO /Users/oelboukh/Desktop/cuby/ray_cast/bbbb.xpm
        EA /Users/oelboukh/Desktop/cuby/ray_cast/bbbb.xpm
                WE /Users/oelboukh/Desktop/cuby/ray_cast/bbbb.xpm
1111111111
1000000001
1111111111
111111111
10000000011111111111
1000000001100000E001
10000000011111111111
1111111111