
F 100,206,100
C 99,99,99


	NO	../texters/pa.xpm
   SO ../texters/bbbbb.xpm
        EA ../texters/img0.xpm
                WE ../texters/pa.xpm
11111111111111111111111111111111111111111
10000000000000000000000000000000000000001
10000001111000000011111000000111100011111
10000000000000000000000000000000000000001
10000001111000000011111000000111100011111
10000000000000000000000000000000000000001
100000011110000S0011111000000111100011111
10000000000000000000000000000000000000001
10000001111000000011111000000111100011111
11111111111111111111111111111111111111111